────┬─────┐
    │     │
┌─╴ │ ┌─┐ │
│   │ │ │ │
│ ╶─┤ │ │ │
│   │ │ │ │
├─╴ ├─┘ │ │
│   │   │ │
│ ╶─┘ ╶─┘ │
│         │
└───────╴ │