────┬─────┐
 · ·│     │
┌─╴ │ ┌─┐ │
│· ·│ │ │ │
│ ╶─┤ │ │ │
│· ·│ │ │ │
├─╴ ├─┘ │ │
│· ·│   │ │
│ ╶─┘ ╶─┘ │
│· · · · ·│
└───────╴ │