────┬───────┬───┬───┐
 · ·│  · · ·│· ·│   │
┌─┐ └─╴ ┌─┐ │ ╷ └─╴ │
│ │· · ·│ │·│·│· · ·│
│ └─────┤ ╵ │ └─┬─╴ │
│       │· ·│· ·│· ·│
│ ╷ ╷ ┌─┘ ┌─┴─╴ │ ┌─┤
│ │ │ │· ·│· · ·│·│ │
│ │ ├─┘ ┌─┘ ╶─┬─┤ ╵ │
│ │ │· ·│  · ·│ │· ·│
├─┘ │ ┌─┴───╴ │ └─┐ │
│   │·│· · · ·│   │·│
│ ╶─┘ │ ╶─────┤ ╶─┘ │
│· · ·│· · · ·│· · ·│
│ ╶─┬─┘ ╶─┬─╴ │ ┌───┤
│· ·│     │· ·│·│   │
├─┐ └───┐ │ ┌─┘ ├─╴ │
│ │· · ·│ │·│· ·│· ·│
│ └───╴ └─┘ │ ╶─┘ ╷ │
│      · · ·│· · ·│·│
└───────────┴─────┘ │