────┬─────┐
 · ·│     │
┌─┐ └─╴ ╷ │
│ │•    │ │
│ └───┬─┘ │
│     │   │
│ ╷ ╷ │ ┌─┤
│ │ │ │ │ │
│ │ └─┘ ╵ │
│ │       │
└─┴─────╴ │