────┬─────┬─────────┬───┬───────┬───────┐
    │     │         │   │       │       │
┌─┐ ╵ ┌─╴ ├───╴ ┌─╴ │ ╶─┘ ╷ ╶─┬─┘ ╷ ╶───┤
│ │   │   │     │   │     │   │   │     │
│ ├───┤ ┌─┘ ╶─┬─┤ ╶─┴─┐ ┌─┴─╴ │ ╶─┴─┬─╴ │
│ │   │ │     │ │     │ │     │     │   │
│ │ ╷ ╵ │ ╶─┐ │ └───┐ │ │ ┌───┴─╴ ┌─┘ ╷ │
│ │ │   │   │ │     │ │ │ │       │   │ │
│ │ └─┬─┴───┘ │ ╶─┐ │ ├─┘ │ ╶─┬───┤ ╶─┴─┤
│ │   │       │   │ │ │   │   │   │     │
│ ├─╴ │ ╶─┬───┘ ╷ └─┤ │ ╶─┴─╴ └─╴ ├───┐ │
│ │   │   │     │   │ │           │   │ │
│ │ ╶─┴─╴ │ ╶─┬─┴─╴ │ └───────┬─╴ └─╴ │ │
│ │       │   │     │         │       │ │
│ └───┬───┼─╴ │ ╶───┴─┬─────┐ └───────┤ │
│     │   │   │       │     │         │ │
├───╴ │ ╷ ╵ ┌─┴─────┐ ╵ ┌─┐ └─────┬─╴ │ │
│     │ │   │       │   │ │       │   │ │
│ ╶───┘ └───┴───╴ ╷ └───┘ └─────┐ ╵ ╶─┘ │
│                 │             │       │
└─────────────────┴─────────────┴─────╴ │