────┬─────┬─────────┬───┬───────┬───────┐
 · ·│· · ·│    · · ·│   │       │       │
┌─┐ ╵ ┌─╴ ├───╴ ┌─╴ │ ╶─┘ ╷ ╶─┬─┘ ╷ ╶───┤
│ │· ·│· ·│· · ·│· ·│     │   │   │     │
│ ├───┤ ┌─┘ ╶─┬─┤ ╶─┴─┐ ┌─┴─╴ │ ╶─┴─┬─╴ │
│ │· ·│·│  · ·│ │· · ·│ │     │     │   │
│ │ ╷ ╵ │ ╶─┐ │ └───┐ │ │ ┌───┴─╴ ┌─┘ ╷ │
│ │·│· ·│   │·│     │·│ │ │       │   │ │
│ │ └─┬─┴───┘ │ ╶─┐ │ ├─┘ │ ╶─┬───┤ ╶─┴─┤
│ │· ·│· · · ·│   │ │·│   │   │   │     │
│ ├─╴ │ ╶─┬───┘ ╷ └─┤ │ ╶─┴─╴ └─╴ ├───┐ │
│ │· ·│· ·│     │   │·│           │   │ │
│ │ ╶─┴─╴ │ ╶─┬─┴─╴ │ └───────┬─╴ └─╴ │ │
│ │· · · ·│   │     │· · · · ·│       │ │
│ └───┬───┼─╴ │ ╶───┴─┬─────┐ └───────┤ │
│     │   │   │       │     │· · · · ·│ │
├───╴ │ ╷ ╵ ┌─┴─────┐ ╵ ┌─┐ └─────┬─╴ │ │
│     │ │   │       │   │ │       │· ·│ │
│ ╶───┘ └───┴───╴ ╷ └───┘ └─────┐ ╵ ╶─┘ │
│                 │             │  · · ·│
└─────────────────┴─────────────┴─────╴ │