──────────┬─┬─────────┬─────┬─────────┬─┐
 · · · · ·│ │    · · ·│· · ·│· · · · ·│ │
┌─────┬─╴ │ ╵ ┌─╴ ┌─┐ │ ╶─┐ ╵ ┌─────┐ ╵ │
│     │· ·│   │· ·│ │·│· ·│· ·│     │· ·│
│ ╶─┐ │ ╶─┤ ╶─┤ ╶─┤ ╵ │ ╷ ├───┘ ┌─╴ ├─╴ │
│· ·│ │· ·│   │· ·│· ·│ │·│     │   │· ·│
│ ╷ └─┼─╴ ├───┼─╴ │ ╶─┴─┘ │ ╶───┤ ┌─┘ ┌─┤
│·│· ·│· ·│· ·│· ·│· · · ·│     │ │· ·│ │
│ ├─┐ ╵ ┌─┘ ╷ │ ╶─┴─┐ ┌───┤ ┌───┤ ╵ ╶─┤ │
│·│ │· ·│· ·│·│· · ·│ │· ·│ │· ·│  · ·│ │
│ ╵ ├───┘ ╶─┤ └─┐ ╷ └─┘ ╷ ├─┘ ╷ └─┬─┐ ╵ │
│· ·│    · ·│· ·│ │· · ·│·│· ·│· ·│ │· ·│
├─┐ └─────┐ ├─╴ ├─┴───┐ │ ╵ ┌─┴─╴ │ └─┐ │
│ │· · · ·│·│· ·│· · ·│ │· ·│· · ·│   │·│
│ └─────┐ │ │ ╶─┘ ┌─┐ └─┤ ┌─┘ ┌───┤ ╶─┘ │
│       │·│·│· · ·│ │· ·│ │· ·│   │· · ·│
│ ╶─┬─╴ │ ╵ ├─────┘ └─┐ └─┤ ┌─┘ ┌─┘ ┌───┤
│   │   │· ·│         │· ·│·│· ·│· ·│   │
├─╴ │ ╶─┴─┬─┤ ┌─┐ ╶─┐ ├─╴ │ │ ╷ ╵ ┌─┤ ╶─┤
│   │     │ │ │ │   │ │· ·│·│·│· ·│ │   │
│ ┌─┴───┐ ╵ │ │ ├─╴ ├─┘ ┌─┘ │ ├───┘ ╵ ╷ │
│ │     │   │ │ │   │· ·│  ·│·│       │ │
│ │ ╶─┐ └─┐ │ ╵ │ ╶─┤ ┌─┴─╴ │ └───────┘ │
│ │   │   │ │   │   │·│· · ·│· · · · · ·│
│ └─┐ └─┐ └─┴─┐ ├─┐ │ │ ╶───┴─┬───┬───┐ │
│   │   │     │ │ │ │·│· · · ·│   │· ·│·│
│ ╷ └─┐ └───┐ ╵ ╵ │ │ │ ┌───╴ │ ┌─┘ ╷ ╵ │
│ │   │     │     │ │·│ │· · ·│ │· ·│· ·│
│ └─┬─┴───╴ ├─────┘ │ └─┘ ┌───┘ │ ┌─┴───┤
│   │       │       │· · ·│     │·│  · ·│
├─╴ │ ┌─────┘ ┌───┐ ├───┬─┘ ╶───┘ ├─╴ ╷ │
│   │ │       │   │ │   │· · · · ·│· ·│·│
│ ╶─┘ │ ╶─┐ ┌─┴─┐ ╵ ╵ ┌─┘ ┌─┬─────┘ ┌─┘ │
│     │   │ │   │     │· ·│ │    · ·│· ·│
├─────┤ ╷ │ │ ╷ └─┬─╴ │ ┌─┘ ╵ ╶─┐ ╶─┤ ┌─┤
│     │ │ │ │ │   │   │·│       │· ·│·│ │
│ ╶─┐ └─┘ │ │ ├─╴ │ ┌─┘ │ ┌─────┴─┐ │ ╵ │
│   │     │ │ │   │ │· ·│ │· · · ·│·│· ·│
│ ╷ └─────┴─┘ │ ╶─┴─┘ ╶─┴─┘ ┌───╴ ╵ ├─╴ │
│ │           │      · · · ·│    · ·│  ·│
└─┴───────────┴─────────────┴───────┴─╴ │