──────────┐
 · · · · ·│
┌─────┬─┐ │
│     │ │·│
│ ╶─┐ ╵ │ │
│   │   │·│
│ ╷ └─┬─┘ │
│ │   │· ·│
│ └─┐ ╵ ╶─┤
│   │  · ·│
└───┴───╴ │