────┬─────┐
 · ·│  · ·│
┌─┐ └─╴ ╷ │
│ │· · ·│•│
│ └───┬─┘ │
│     │   │
│ ╷ ╷ │ ┌─┤
│ │ │ │ │ │
│ │ └─┘ ╵ │
│ │       │
└─┴─────╴ │