────┬─────┐
 · ·│  · ·│
┌─┐ └─╴ ╷ │
│ │· · ·│·│
│ └───┬─┘ │
│     │· ·│
│ ╷ ╷ │ ┌─┤
│ │ │ │•│ │
│ │ └─┘ ╵ │
│ │       │
└─┴─────╴ │