──────────┬─┬───────┐
          │ │       │
┌─────┬─╴ │ ╵ ┌─╴ ╷ │
│     │   │   │   │ │
│ ╶─┐ │ ╶─┤ ╶─┤ ┌─┘ │
│   │ │   │   │ │   │
│ ╷ └─┼─╴ ├───┤ ├───┤
│ │   │   │   │ │   │
│ ├─┐ ╵ ┌─┘ ╷ │ ╵ ╷ │
│ │ │   │   │ │   │ │
│ ╵ ├───┘ ╶─┤ └─┐ │ │
│   │       │   │ │ │
├─┐ └─────┐ ├─╴ ├─┘ │
│ │       │ │   │   │
│ └─────┐ │ │ ╶─┘ ╷ │
│       │ │ │     │ │
│ ┌─┬─╴ │ ╵ ├─────┘ │
│ │ │   │   │       │
│ ╵ │ ╶─┴───┘ ╶─────┤
│   │               │
└───┴─────────────╴ │