────┬─────┐
 · ·│  •  │
┌─┐ └─╴ ╷ │
│ │· · ·│ │
│ └───┬─┘ │
│     │   │
│ ╷ ╷ │ ┌─┤
│ │ │ │ │ │
│ │ └─┘ ╵ │
│ │       │
└─┴─────╴ │