────┬─────┐
 · ·│  · •│
┌─┐ └─╴ ╷ │
│ │· · ·│ │
│ └───┬─┘ │
│     │   │
│ ╷ ╷ │ ┌─┤
│ │ │ │ │ │
│ │ └─┘ ╵ │
│ │       │
└─┴─────╴ │