────┬───────┬───┬───────────────────────┐
    │       │   │                       │
┌─┐ └─╴ ┌─┐ │ ╷ └─╴ ┌─────────┬───────╴ │
│ │     │ │ │ │     │         │         │
│ └─────┤ ╵ │ └─┬─┬─┘ ┌───┐ ╶─┤ ╶───┬───┤
│       │   │   │ │   │   │   │     │   │
│ ╷ ╷ ┌─┘ ┌─┴─╴ │ │ ┌─┴─╴ ├─╴ └───┐ └─┐ │
│ │ │ │   │     │ │ │     │       │   │ │
│ │ ├─┘ ┌─┘ ╶─┬─┘ ╵ ├─╴ ┌─┘ ┌─────┴─┐ ╵ │
│ │ │   │     │     │   │   │       │   │
├─┘ │ ┌─┴───╴ │ ┌───┘ ╶─┤ ╶─┘ ┌─┬─╴ └─┐ │
│   │ │       │ │       │     │ │     │ │
│ ╶─┘ │ ╶─────┤ │ ┌───┐ └─────┘ │ ╶─┐ │ │
│     │       │ │ │   │         │   │ │ │
│ ╶─┬─┘ ╶─┬─╴ │ │ ╵ ╷ └─┐ ╶─┬─┐ └─┐ ├─┘ │
│   │     │   │ │   │   │   │ │   │ │   │
├─┐ └───┐ │ ┌─┘ ├───┴───┤ ╷ │ ├─╴ │ ╵ ┌─┤
│ │     │ │ │   │       │ │ │ │   │   │ │
│ └───╴ └─┘ │ ╶─┘ ┌───╴ └─┘ │ ╵ ╶─┴───┘ │
│           │     │         │           │
└───────────┴─────┴─────────┴─────────╴ │