────┬─────┐
 · ·│  · ·│
┌─┐ └─╴ ╷ │
│ │· · ·│·│
│ └───┬─┘ │
│     │• ·│
│ ╷ ╷ │ ┌─┤
│ │ │ │ │ │
│ │ └─┘ ╵ │
│ │       │
└─┴─────╴ │