────┬─────┬─────────┬───┬───────┬───────┐
 · ·│· · ·│    · · ·│   │       │       │
┌─┐ ╵ ┌─╴ ├───╴ ┌─╴ │ ╶─┘ ╷ ╶─┬─┘ ╷ ╶───┤
│ │· ·│· ·│· · ·│· ·│     │   │   │     │
│ ├───┤ ┌─┘ ╶─┬─┤ ╶─┴─┐ ┌─┴─╴ │ ╶─┴─┬─╴ │
│ │· ·│·│  · ·│ │· · ·│ │     │     │   │
│ │ ╷ ╵ │ ╶─┐ │ └───┐ │ │ ┌───┴─╴ ┌─┘ ╷ │
│ │·│· ·│   │·│     │·│ │ │       │   │ │
│ │ └─┬─┴───┘ │ ╶─┐ │ ├─┘ │ ╶─┬───┤ ╶─┴─┤
│ │· ·│· · · ·│· ·│ │·│   │   │   │     │
│ ├─╴ │ ╶─┬───┘ ╷ └─┤ │ ╶─┴─╴ └─╴ ├───┐ │
│ │· ·│· ·│· · ·│· ·│·│           │   │ │
│ │ ╶─┴─╴ │ ╶─┬─┴─╴ │ └───────┬─╴ └─╴ │ │
│ │· · · ·│· ·│· · ·│· · · · ·│       │ │
│ └───┬───┼─╴ │ ╶───┴─┬─────┐ └───────┤ │
│     │· ·│· ·│· · · ·│· · ·│· · · · ·│ │
├───╴ │ ╷ ╵ ┌─┴─────┐ ╵ ┌─┐ └─────┬─╴ │ │
│     │·│· ·│       │· ·│ │· · · ·│· ·│ │
│ ╷ ┌─┘ ├───┴─╴ ╷ ┌─┴───┘ └───┬─┐ ╵ ┌─┘ │
│ │ │· ·│       │ │    · · · ·│ │· ·│· ·│
│ │ │ ┌─┘ ╶─────┴─┘ ┌─┐ ╶─┬─╴ ╵ └─┬─┘ ╷ │
│ │ │·│             │ │· ·│  · · ·│· ·│·│
│ └─┘ │ ╶───────┬───┘ └─┐ └───┬─┐ ╵ ┌─┤ │
│· · ·│         │       │· · ·│ │· ·│ │·│
│ ╶───┼───────┐ └───┐ ╷ └───┐ │ └─┬─┘ │ │
│· · ·│       │     │ │     │·│   │· ·│·│
├───┐ │ ╷ ╶─┐ ├───┐ └─┘ ┌─┐ │ │ ┌─┘ ╷ │ │
│   │·│ │   │ │   │     │ │ │·│ │· ·│·│·│
│ ╷ │ ├─┴─╴ ├─┘ ╷ └─────┘ ╵ │ │ ╵ ╶─┤ ╵ │
│ │ │·│     │   │           │·│  · ·│· ·│
├─┘ │ │ ╶───┤ ┌─┴─┬───┐ ╶───┤ ├───┐ └─┬─┤
│   │·│     │ │   │· ·│     │·│· ·│· ·│ │
│ ╶─┤ │ ┌─┐ │ ╵ ┌─┘ ╷ ├───╴ │ ╵ ╷ ├─┐ ╵ │
│   │·│ │ │ │   │· ·│·│     │· ·│·│ │· ·│
│ ╷ │ │ ╵ │ └─╴ │ ┌─┘ └─────┤ ╶─┤ │ └─┐ │
│ │ │·│   │     │·│  · · · ·│   │·│   │·│
│ │ │ └───┼───┐ │ └───────┐ └─┬─┘ │ ╷ │ │
│ │ │· · ·│· ·│ │· · · · ·│· ·│· ·│ │ │·│
│ │ └───╴ ╵ ╷ └─┴───────╴ ├─╴ ╵ ┌─┘ │ ╵ │
│ │      · ·│· · · · · · ·│  · ·│   │  ·│
└─┴─────────┴─────────────┴─────┴───┴─╴ │