──────────┬─┬───────┐
 · · · · ·│ │       │
┌─────┬─╴ │ ╵ ┌─╴ ╷ │
│     │· ·│   │   │ │
│ ╶─┐ │ ╶─┤ ╶─┤ ┌─┘ │
│· ·│ │· ·│   │ │   │
│ ╷ └─┼─╴ ├───┤ ├───┤
│·│· ·│· ·│· ·│ │   │
│ ├─┐ ╵ ┌─┘ ╷ │ ╵ ╷ │
│·│ │· ·│· ·│·│   │ │
│ ╵ ├───┘ ╶─┤ └─┐ │ │
│· ·│    · ·│· ·│ │ │
├─┐ └─────┐ ├─╴ ├─┘ │
│ │· · · ·│·│· ·│· ·│
│ └─────┐ │ │ ╶─┘ ╷ │
│       │·│·│· · ·│·│
│ ┌─┬─╴ │ ╵ ├─────┘ │
│ │ │   │· ·│· · · ·│
│ ╵ │ ╶─┴───┘ ╶─────┤
│   │        · · · ·│
└───┴─────────────╴ │