────┬─────┐
    │     │
┌─┐ ╵ ┌─╴ │
│ │   │   │
│ ├───┤ ┌─┤
│ │   │ │ │
│ │ ╷ ╵ │ │
│ │ │   │ │
│ ╵ └───┘ │
│         │
└───────╴ │