──────────┬─┬─────────┬─────┬─────────┬─┐
          │ │         │     │         │ │
┌─────┬─╴ │ ╵ ┌─╴ ┌─┐ │ ┌─╴ ╵ ┌─────╴ ╵ │
│     │   │   │   │ │ │ │     │         │
│ ╶─┐ │ ╶─┤ ╶─┤ ╶─┤ ╵ ╵ │ ┌───┴─────┬─╴ │
│   │ │   │   │   │     │ │         │   │
│ ╷ └─┼─╴ ├───┼─╴ │ ┌───┤ │ ┌─────┐ │ ╶─┤
│ │   │   │   │   │ │   │ │ │     │ │   │
│ ├─┐ ╵ ┌─┘ ╷ │ ╶─┴─┤ ╷ ├─┘ │ ╶─┐ │ └─┐ │
│ │ │   │   │ │     │ │ │   │   │ │   │ │
│ ╵ ├───┘ ╶─┤ └─┐ ╷ ╵ │ │ ╶─┴─┐ └─┴─┐ └─┤
│   │       │   │ │   │ │     │     │   │
├─┐ └─────┐ ├─╴ ├─┴───┤ └───┐ └─╴ ┌─┴─╴ │
│ │       │ │   │     │     │     │     │
│ └─────┐ │ │ ╶─┘ ┌─┐ └─┐ ╷ └───╴ │ ┌─╴ │
│       │ │ │     │ │   │ │       │ │   │
│ ┌─┬─╴ │ ╵ ├─────┘ └─┐ └─┤ ╶─┬───┘ │ ╶─┤
│ │ │   │   │         │   │   │     │   │
│ ╵ │ ╶─┴───┘ ╷ ╶─────┴─╴ └───┘ ┌───┴─╴ │
│   │         │                 │       │
└───┴─────────┴─────────────────┴─────╴ │