────┬───────┬───┬───────────────────────┐
 · ·│  · · ·│· ·│  · · · · · · · · · · ·│
┌─┐ └─╴ ┌─┐ │ ╷ └─╴ ┌─────────┬───────╴ │
│ │· · ·│ │·│·│· · ·│· · · ·  │· · · · ·│
│ └─────┤ ╵ │ └─┬─┬─┘ ┌───┐ ╶─┤ ╶───┬───┤
│       │· ·│· ·│ │· ·│   │· ·│· · ·│   │
│ ╷ ╷ ┌─┘ ┌─┴─╴ │ │ ┌─┴─╴ ├─╴ └───┐ └─┐ │
│ │ │ │· ·│· · ·│ │·│     │· ·    │· ·│ │
│ │ ├─┘ ┌─┘ ╶─┬─┘ ╵ ├─╴ ┌─┘ ┌─────┴─┐ ╵ │
│ │ │· ·│  · ·│· · ·│   │· ·│· · · ·│· ·│
├─┘ │ ┌─┴───╴ │ ┌───┘ ╶─┤ ╶─┘ ┌─┬─╴ └─┐ │
│   │·│· · · ·│·│       │· · ·│ │· ·  │·│
│ ╶─┘ │ ╶─────┤ │ ┌───┐ └─────┘ │ ╶─┐ │ │
│· · ·│· · · ·│·│ │   │  · · · ·│· ·│ │·│
│ ╶─┬─┘ ╶─┬─╴ │ │ ╵ ╷ └─┐ ╶─┬─┐ └─┐ ├─┘ │
│· ·│     │· ·│·│   │   │· ·│ │· ·│·│· ·│
├─┐ └───┐ │ ┌─┘ ├───┴───┤ ╷ │ ├─╴ │ ╵ ┌─┤
│ │· · ·│ │·│· ·│· · · ·│ │·│ │· ·│· ·│ │
│ └───╴ └─┘ │ ╶─┘ ┌───╴ └─┘ │ ╵ ╶─┴───┘ │
│      · · ·│· · ·│    · · ·│  · · · · ·│
└───────────┴─────┴─────────┴─────────╴ │