────┬─────┬─────────┬───┬───────┬───────┐
    │     │         │   │       │       │
┌─┐ ╵ ┌─╴ ├───╴ ┌─╴ │ ╶─┘ ╷ ╶─┬─┘ ╷ ╶───┤
│ │   │   │     │   │     │   │   │     │
│ ├───┤ ┌─┘ ╶─┬─┤ ╶─┴─┐ ┌─┴─╴ │ ╶─┴─┬─╴ │
│ │   │ │     │ │     │ │     │     │   │
│ │ ╷ ╵ │ ╶─┐ │ └───┐ │ │ ┌───┴─╴ ┌─┘ ╷ │
│ │ │   │   │ │     │ │ │ │       │   │ │
│ │ └─┬─┴───┘ │ ╶─┐ │ ├─┘ │ ╶─┬───┤ ╶─┴─┤
│ │   │       │   │ │ │   │   │   │     │
│ ├─╴ │ ╶─┬───┘ ╷ └─┤ │ ╶─┴─╴ └─╴ ├───┐ │
│ │   │   │     │   │ │           │   │ │
│ │ ╶─┴─╴ │ ╶─┬─┴─╴ │ └───────┬─╴ └─╴ │ │
│ │       │   │     │         │       │ │
│ └───┬───┼─╴ │ ╶───┴─┬─────┐ └───────┤ │
│     │   │   │       │     │         │ │
├───╴ │ ╷ ╵ ┌─┴─────┐ ╵ ┌─┐ └─────┬─╴ │ │
│     │ │   │       │   │ │       │   │ │
│ ╷ ┌─┘ ├───┴─╴ ╷ ┌─┴───┘ └───┬─┐ ╵ ┌─┘ │
│ │ │   │       │ │           │ │   │   │
│ │ │ ┌─┘ ╶─────┴─┘ ┌─┐ ╶─┬─╴ ╵ └─┬─┘ ╷ │
│ │ │ │             │ │   │       │   │ │
│ └─┘ │ ╶───────┬───┘ └─┐ └───┬─┐ ╵ ┌─┤ │
│     │         │       │     │ │   │ │ │
│ ╶───┼───────┐ └───┐ ╷ └───┐ │ └─┬─┘ │ │
│     │       │     │ │     │ │   │   │ │
├───┐ │ ╷ ╶─┐ ├───┐ └─┘ ┌─┐ │ │ ┌─┘ ╷ │ │
│   │ │ │   │ │   │     │ │ │ │ │   │ │ │
│ ╷ │ ├─┴─╴ ├─┘ ╷ └─────┘ ╵ │ │ ╵ ╶─┤ ╵ │
│ │ │ │     │   │           │ │     │   │
├─┘ │ │ ╶───┤ ┌─┴─┬───┐ ╶───┤ ├───┐ └─┬─┤
│   │ │     │ │   │   │     │ │   │   │ │
│ ╶─┤ │ ┌─┐ │ ╵ ┌─┘ ╷ ├───╴ │ ╵ ╷ ├─┐ ╵ │
│   │ │ │ │ │   │   │ │     │   │ │ │   │
│ ╷ │ │ ╵ │ └─╴ │ ┌─┘ └─────┤ ╶─┤ │ └─┐ │
│ │ │ │   │     │ │         │   │ │   │ │
│ │ │ └───┼───┐ │ └───────┐ └─┬─┘ │ ╷ │ │
│ │ │     │   │ │         │   │   │ │ │ │
│ │ └───╴ ╵ ╷ └─┴───────╴ ├─╴ ╵ ┌─┘ │ ╵ │
│ │         │             │     │   │   │
└─┴─────────┴─────────────┴─────┴───┴─╴ │