────┬─────┬─────────┐
 · ·│· · ·│    · · ·│
┌─┐ ╵ ┌─╴ ├───╴ ┌─┐ │
│ │· ·│· ·│· · ·│ │·│
│ ├───┤ ┌─┘ ╶─┬─┤ ╵ │
│ │· ·│·│  · ·│ │· ·│
│ │ ╷ ╵ │ ╶─┐ │ ╵ ┌─┤
│ │·│· ·│   │·│· ·│ │
│ │ └─┬─┴───┘ │ ┌─┘ │
│ │· ·│· · · ·│·│   │
│ ├─╴ │ ╶─┬───┘ │ ╶─┤
│ │· ·│· ·│· · ·│   │
│ │ ╶─┴─╴ │ ╶───┴─╴ │
│ │· · · ·│· · · · ·│
│ └───┬───┼───────╴ │
│     │· ·│· · · · ·│
├───╴ │ ╷ ╵ ┌───────┤
│     │·│· ·│    · ·│
│ ╶───┘ └───┴───╴ ╷ │
│      · · · · · ·│·│
└─────────────────┘ │