────┬───────┬───┬───────────────────────┐
 · ·│  · · ·│· ·│  · · · · · · · · · · ·│
┌─┐ └─╴ ┌─┐ │ ╷ └─╴ ┌─────────┬───────╴ │
│ │· · ·│ │·│·│· · ·│· · · ·  │· · · · ·│
│ └─────┤ ╵ │ └─┬─┬─┘ ┌───┐ ╶─┤ ╶───┬───┤
│       │· ·│· ·│ │· ·│   │· ·│· · ·│   │
│ ╷ ╷ ┌─┘ ┌─┴─╴ │ │ ┌─┴─╴ ├─╴ └───┐ └─┐ │
│ │ │ │· ·│· · ·│ │·│     │· ·    │· ·│ │
│ │ ├─┘ ┌─┘ ╶─┬─┘ ╵ ├─╴ ┌─┘ ┌─────┴─┐ ╵ │
│ │ │· ·│  · ·│· · ·│   │· ·│· · · ·│· ·│
├─┘ │ ┌─┴───╴ │ ┌───┘ ╶─┤ ╶─┘ ┌─┬─╴ └─┐ │
│   │·│· · · ·│·│       │· · ·│ │· ·  │·│
│ ╶─┘ │ ╶─────┤ │ ┌───┐ └─────┘ │ ╶─┐ │ │
│· · ·│· · · ·│·│ │   │         │· ·│ │·│
│ ╶─┬─┘ ╶─┬─╴ │ │ ╵ ╷ └─┐ ╶─────┴─┐ ├─┘ │
│· ·│     │· ·│·│   │   │         │·│· ·│
├─┐ └───┐ │ ╶─┤ └─┬─┴───┤ ╶─┬─┬─╴ │ ╵ ┌─┤
│ │· · ·│ │· ·│· ·│· · ·│   │ │   │· ·│ │
│ └───┐ │ └─┐ └─┐ ╵ ┌─┐ ├─╴ │ │ ╶─┴───┘ │
│     │·│   │· ·│· ·│ │·│   │ │         │
│ ┌─╴ │ └─┐ └─┐ ├─┬─┘ ╵ │ ┌─┘ ├───────╴ │
│ │   │· ·│   │·│ │· · ·│ │   │         │
│ │ ╷ ├─┐ └───┘ │ ╵ ┌─┬─┘ ├─╴ │ ╶─┬───╴ │
│ │ │ │ │· · · ·│· ·│ │   │   │   │     │
├─┘ │ ╵ └─┬─────┘ ┌─┘ │ ╶─┘ ╷ ├─┐ └─┐ ╶─┤
│   │     │· · · ·│   │     │ │ │   │   │
│ ┌─┘ ┌───┘ ┌───┬─┘ ╶─┴─────┤ │ └─┐ ├───┤
│ │   │· · ·│· ·│           │ │   │ │   │
│ │ ╶─┤ ╶───┤ ╷ │ ╶─┬───┐ ╶─┘ └─┐ │ ╵ ╷ │
│ │   │· · ·│·│·│   │   │       │ │   │ │
│ ├───┴─┬─╴ │ │ ├─╴ └─╴ ├─────┐ ╵ └─┬─┘ │
│ │     │· ·│·│·│       │· · ·│     │· ·│
│ │ ╶─┐ │ ╶─┤ │ └───┬───┘ ┌─┐ └─┐ ┌─┘ ╷ │
│ │   │ │· ·│·│· · ·│· · ·│ │· ·│ │· ·│·│
│ └─┐ │ └─┐ ╵ ├───╴ │ ┌───┘ └─┐ ├─┘ ┌─┘ │
│   │ │   │· ·│· · ·│·│       │·│· ·│· ·│
├─╴ │ └─┐ └───┤ ┌───┘ └───┐ ╷ │ ╵ ┌─┤ ╶─┤
│   │   │     │·│    · · ·│ │ │· ·│ │· ·│
│ ╶─┴─╴ │ ╶───┘ └───────╴ │ │ └───┘ └─╴ │
│       │      · · · · · ·│ │          ·│
└───────┴─────────────────┴─┴─────────╴ │