────┬───────┬───┬───┐
    │       │   │   │
┌─┐ └─╴ ┌─┐ │ ╷ └─╴ │
│ │     │ │ │ │     │
│ └─────┤ ╵ │ └─┬─╴ │
│       │   │   │   │
│ ╷ ╷ ┌─┘ ┌─┴─╴ │ ┌─┤
│ │ │ │   │     │ │ │
│ │ ├─┘ ┌─┘ ╶─┬─┤ ╵ │
│ │ │   │     │ │   │
├─┘ │ ┌─┴───╴ │ └─┐ │
│   │ │       │   │ │
│ ╶─┘ │ ╶─────┤ ╶─┘ │
│     │       │     │
│ ╶─┬─┘ ╶─┬─╴ │ ┌───┤
│   │     │   │ │   │
├─┐ └───┐ │ ┌─┘ ├─╴ │
│ │     │ │ │   │   │
│ └───╴ └─┘ │ ╶─┘ ╷ │
│           │     │ │
└───────────┴─────┘ │