────┬─────┐
 •  │     │
┌─┐ └─╴ ╷ │
│ │     │ │
│ └───┬─┘ │
│     │   │
│ ╷ ╷ │ ┌─┤
│ │ │ │ │ │
│ │ └─┘ ╵ │
│ │       │
└─┴─────╴ │