──────────┬─┬─────────┬─────┬─────────┬─┐
          │ │         │     │         │ │
┌─────┬─╴ │ ╵ ┌─╴ ┌─┐ │ ╶─┐ ╵ ┌─────┐ ╵ │
│     │   │   │   │ │ │   │   │     │   │
│ ╶─┐ │ ╶─┤ ╶─┤ ╶─┤ ╵ │ ╷ ├───┘ ┌─╴ ├─╴ │
│   │ │   │   │   │   │ │ │     │   │   │
│ ╷ └─┼─╴ ├───┼─╴ │ ╶─┴─┘ │ ╶───┤ ┌─┘ ┌─┤
│ │   │   │   │   │       │     │ │   │ │
│ ├─┐ ╵ ┌─┘ ╷ │ ╶─┴─┐ ┌───┤ ┌───┤ ╵ ╶─┤ │
│ │ │   │   │ │     │ │   │ │   │     │ │
│ ╵ ├───┘ ╶─┤ └─┐ ╷ └─┘ ╷ ├─┘ ╷ └─┬─┐ ╵ │
│   │       │   │ │     │ │   │   │ │   │
├─┐ └─────┐ ├─╴ ├─┴───┐ │ ╵ ┌─┴─╴ │ └─┐ │
│ │       │ │   │     │ │   │     │   │ │
│ └─────┐ │ │ ╶─┘ ┌─┐ └─┤ ┌─┘ ┌───┤ ╶─┘ │
│       │ │ │     │ │   │ │   │   │     │
│ ╶─┬─╴ │ ╵ ├─────┘ └─┐ └─┤ ┌─┘ ┌─┘ ┌───┤
│   │   │   │         │   │ │   │   │   │
├─╴ │ ╶─┴─┬─┤ ┌─┐ ╶─┐ ├─╴ │ │ ╷ ╵ ┌─┤ ╶─┤
│   │     │ │ │ │   │ │   │ │ │   │ │   │
│ ┌─┴───┐ ╵ │ │ ├─╴ ├─┘ ┌─┘ │ ├───┘ ╵ ╷ │
│ │     │   │ │ │   │   │   │ │       │ │
│ │ ╶─┐ └─┐ │ ╵ │ ╶─┤ ┌─┴─╴ │ └───────┘ │
│ │   │   │ │   │   │ │     │           │
│ └─┐ └─┐ └─┴─┐ ├─┐ │ │ ╶───┴─┬───┬───┐ │
│   │   │     │ │ │ │ │       │   │   │ │
│ ╷ └─┐ └───┐ ╵ ╵ │ │ │ ┌───╴ │ ┌─┘ ╷ ╵ │
│ │   │     │     │ │ │ │     │ │   │   │
│ └─┬─┴───╴ ├─────┘ │ └─┘ ┌───┘ │ ┌─┴───┤
│   │       │       │     │     │ │     │
├─╴ │ ┌─────┘ ┌───┐ ├───┬─┘ ╶───┘ ├─╴ ╷ │
│   │ │       │   │ │   │         │   │ │
│ ╶─┘ │ ╶─┐ ┌─┴─┐ ╵ ╵ ┌─┘ ┌─┬─────┘ ┌─┘ │
│     │   │ │   │     │   │ │       │   │
├─────┤ ╷ │ │ ╷ └─┬─╴ │ ┌─┘ ╵ ╶─┐ ╶─┤ ┌─┤
│     │ │ │ │ │   │   │ │       │   │ │ │
│ ╶─┐ └─┘ │ │ ├─╴ │ ┌─┘ │ ┌─────┴─┐ │ ╵ │
│   │     │ │ │   │ │   │ │       │ │   │
│ ╷ └─────┴─┘ │ ╶─┴─┘ ╶─┴─┘ ┌───╴ ╵ ├─╴ │
│ │           │             │       │   │
└─┴───────────┴─────────────┴───────┴─╴ │