────┬─────┐
 · •│     │
┌─┐ └─╴ ╷ │
│ │     │ │
│ └───┬─┘ │
│     │   │
│ ╷ ╷ │ ┌─┤
│ │ │ │ │ │
│ │ └─┘ ╵ │
│ │       │
└─┴─────╴ │