────┬─────┐
 · ·│  · ·│
┌─┐ └─╴ ╷ │
│ │· · ·│·│
│ └───┬─┘ │
│     │· ·│
│ ╷ ╷ │ ┌─┤
│ │ │ │·│ │
│ │ └─┘ ╵ │
│ │    · •│
└─┴─────╴ │