──────────┐
          │
┌─────┬─┐ │
│     │ │ │
│ ╶─┐ ╵ │ │
│   │   │ │
│ ╷ └─┬─┘ │
│ │   │   │
│ └─┐ ╵ ╶─┤
│   │     │
└───┴───╴ │