────┬─────┐
 · ·│· · ·│
┌─┐ ╵ ┌─╴ │
│ │· ·│· ·│
│ ├───┤ ┌─┤
│ │· ·│·│ │
│ │ ╷ ╵ │ │
│ │·│· ·│ │
│ ╵ └───┘ │
│  · · · ·│
└───────╴ │