────┬─────┬─────────┐
    │     │         │
┌─┐ ╵ ┌─╴ ├───╴ ┌─┐ │
│ │   │   │     │ │ │
│ ├───┤ ┌─┘ ╶─┬─┤ ╵ │
│ │   │ │     │ │   │
│ │ ╷ ╵ │ ╶─┐ │ ╵ ┌─┤
│ │ │   │   │ │   │ │
│ │ └─┬─┴───┘ │ ┌─┘ │
│ │   │       │ │   │
│ ├─╴ │ ╶─┬───┘ │ ╶─┤
│ │   │   │     │   │
│ │ ╶─┴─╴ │ ╶───┴─╴ │
│ │       │         │
│ └───┬───┼───────╴ │
│     │   │         │
├───╴ │ ╷ ╵ ┌───────┤
│     │ │   │       │
│ ╶───┘ └───┴───╴ ╷ │
│                 │ │
└─────────────────┘ │