────┬───────┬───┬───────────────────────┐
    │       │   │                       │
┌─┐ └─╴ ┌─┐ │ ╷ └─╴ ┌─────────┬───────╴ │
│ │     │ │ │ │     │         │         │
│ └─────┤ ╵ │ └─┬─┬─┘ ┌───┐ ╶─┤ ╶───┬───┤
│       │   │   │ │   │   │   │     │   │
│ ╷ ╷ ┌─┘ ┌─┴─╴ │ │ ┌─┴─╴ ├─╴ └───┐ └─┐ │
│ │ │ │   │     │ │ │     │       │   │ │
│ │ ├─┘ ┌─┘ ╶─┬─┘ ╵ ├─╴ ┌─┘ ┌─────┴─┐ ╵ │
│ │ │   │     │     │   │   │       │   │
├─┘ │ ┌─┴───╴ │ ┌───┘ ╶─┤ ╶─┘ ┌─┬─╴ └─┐ │
│   │ │       │ │       │     │ │     │ │
│ ╶─┘ │ ╶─────┤ │ ┌───┐ └─────┘ │ ╶─┐ │ │
│     │       │ │ │   │         │   │ │ │
│ ╶─┬─┘ ╶─┬─╴ │ │ ╵ ╷ └─┐ ╶─────┴─┐ ├─┘ │
│   │     │   │ │   │   │         │ │   │
├─┐ └───┐ │ ╶─┤ └─┬─┴───┤ ╶─┬─┬─╴ │ ╵ ┌─┤
│ │     │ │   │   │     │   │ │   │   │ │
│ └───┐ │ └─┐ └─┐ ╵ ┌─┐ ├─╴ │ │ ╶─┴───┘ │
│     │ │   │   │   │ │ │   │ │         │
│ ┌─╴ │ └─┐ └─┐ ├─┬─┘ ╵ │ ┌─┘ ├───────╴ │
│ │   │   │   │ │ │     │ │   │         │
│ │ ╷ ├─┐ └───┘ │ ╵ ┌─┬─┘ ├─╴ │ ╶─┬───╴ │
│ │ │ │ │       │   │ │   │   │   │     │
├─┘ │ ╵ └─┬─────┘ ┌─┘ │ ╶─┘ ╷ ├─┐ └─┐ ╶─┤
│   │     │       │   │     │ │ │   │   │
│ ┌─┘ ┌───┘ ┌───┬─┘ ╶─┴─────┤ │ └─┐ ├───┤
│ │   │     │   │           │ │   │ │   │
│ │ ╶─┤ ╶───┤ ╷ │ ╶─┬───┐ ╶─┘ └─┐ │ ╵ ╷ │
│ │   │     │ │ │   │   │       │ │   │ │
│ ├───┴─┬─╴ │ │ ├─╴ └─╴ ├─────┐ ╵ └─┬─┘ │
│ │     │   │ │ │       │     │     │   │
│ │ ╶─┐ │ ╶─┤ │ └───┬───┘ ┌─┐ └─┐ ┌─┘ ╷ │
│ │   │ │   │ │     │     │ │   │ │   │ │
│ └─┐ │ └─┐ ╵ ├───╴ │ ┌───┘ └─┐ ├─┘ ┌─┘ │
│   │ │   │   │     │ │       │ │   │   │
├─╴ │ └─┐ └───┤ ┌───┘ └───┐ ╷ │ ╵ ┌─┤ ╶─┤
│   │   │     │ │         │ │ │   │ │   │
│ ╶─┴─╴ │ ╶───┘ └───────╴ │ │ └───┘ └─╴ │
│       │                 │ │           │
└───────┴─────────────────┴─┴─────────╴ │