──────────┬─┬─────────┬─────┬─────────┬─┐
 · · · · ·│ │         │     │         │ │
┌─────┬─╴ │ ╵ ┌─╴ ┌─┐ │ ┌─╴ ╵ ┌─────╴ ╵ │
│     │· ·│   │   │ │ │ │     │         │
│ ╶─┐ │ ╶─┤ ╶─┤ ╶─┤ ╵ ╵ │ ┌───┴─────┬─╴ │
│· ·│ │· ·│   │   │     │ │         │   │
│ ╷ └─┼─╴ ├───┼─╴ │ ┌───┤ │ ┌─────┐ │ ╶─┤
│·│· ·│· ·│· ·│   │ │   │ │ │     │ │   │
│ ├─┐ ╵ ┌─┘ ╷ │ ╶─┴─┤ ╷ ├─┘ │ ╶─┐ │ └─┐ │
│·│ │· ·│· ·│·│     │ │ │   │   │ │   │ │
│ ╵ ├───┘ ╶─┤ └─┐ ╷ ╵ │ │ ╶─┴─┐ └─┴─┐ └─┤
│· ·│    · ·│· ·│ │   │ │     │     │   │
├─┐ └─────┐ ├─╴ ├─┴───┤ └───┐ └─╴ ┌─┴─╴ │
│ │· · · ·│·│· ·│· · ·│     │     │· · ·│
│ └─────┐ │ │ ╶─┘ ┌─┐ └─┐ ╷ └───╴ │ ┌─╴ │
│       │·│·│· · ·│ │· ·│ │       │·│· ·│
│ ┌─┬─╴ │ ╵ ├─────┘ └─┐ └─┤ ╶─┬───┘ │ ╶─┤
│ │ │   │· ·│         │· ·│   │· · ·│· ·│
│ ╵ │ ╶─┴───┘ ╷ ╶─────┴─╴ └───┘ ┌───┴─╴ │
│   │         │          · · · ·│      ·│
└───┴─────────┴─────────────────┴─────╴ │