────┬───────┬───┬───────────────────────┬─────┬─┬─────────┬─────────────┬───────┐
    │       │   │                       │     │ │         │             │       │
┌─┐ └─╴ ┌─┐ │ ╷ └─╴ ┌─────────┬───────╴ │ ╷ ╷ ╵ │ ┌─┐ ┌─╴ │ ┌───┐ ┌───╴ ├─╴ ┌─╴ │
│ │     │ │ │ │     │         │         │ │ │   │ │ │ │   │ │   │ │     │   │   │
│ └─────┤ ╵ │ └─┬─┬─┘ ┌───┐ ╶─┤ ╶───┬───┴─┤ ├───┘ │ │ └─┐ └─┘ ╷ ╵ │ ┌─┬─┘ ╶─┴─┐ │
│       │   │   │ │   │   │   │     │     │ │     │ │   │     │   │ │ │       │ │
│ ╷ ╷ ┌─┘ ┌─┴─╴ │ │ ┌─┴─╴ ├─╴ └───┐ └─┐ ╷ │ ╵ ╶───┤ └─┐ ├─────┼───┘ │ ╵ ┌───╴ │ │
│ │ │ │   │     │ │ │     │       │   │ │ │       │   │ │     │     │   │     │ │
│ │ ├─┘ ┌─┘ ╶─┬─┘ ╵ ├─╴ ┌─┘ ┌─────┴─┐ ╵ │ │ ┌───┐ ╵ ╷ │ │ ╷ ┌─┘ ┌───┴─┬─┘ ┌───┤ │
│ │ │   │     │     │   │   │       │   │ │ │   │   │ │ │ │ │   │     │   │   │ │
├─┘ │ ┌─┴───╴ │ ┌───┘ ╶─┤ ╶─┘ ┌─┬─╴ ├───┘ ├─┘ ╷ ├───┤ │ │ ├─┘ ┌─┘ ┌─┐ ╵ ┌─┘ ╷ │ │
│   │ │       │ │       │     │ │   │     │   │ │   │ │ │ │   │   │ │   │   │ │ │
│ ╶─┘ │ ╶─────┤ │ ┌───┐ └─────┘ │ ╶─┘ ┌───┘ ┌─┤ └─┐ ╵ │ │ ╵ ┌─┴─┐ │ └───┴───┘ │ │
│     │       │ │ │   │         │     │     │ │   │   │ │   │   │ │           │ │
│ ╶─┬─┘ ╶─┬─╴ │ │ ╵ ╷ └─┐ ╶─┬─╴ ├───┬─┴───╴ │ └─╴ │ ┌─┘ │ ╶─┘ ╷ ╵ ├───╴ ┌───╴ │ │
│   │     │   │ │   │   │   │   │   │       │     │ │   │     │   │     │     │ │
├─┐ └───┐ │ ╶─┤ └─┬─┴───┤ ╷ │ ┌─┘ ╷ ╵ ╷ ┌───┤ ╶───┴─┘ ┌─┼─────┴─┬─┘ ╶─┬─┤ ┌───┤ │
│ │     │ │   │   │     │ │ │ │   │   │ │   │         │ │       │     │ │ │   │ │
│ └───┐ │ └─┐ └─┐ ╵ ┌─┐ ├─┘ ├─┘ ╶─┴───┤ │ ╷ ├───────┬─┘ ╵ ┌─┐ ╶─┘ ┌─┐ │ ╵ └─╴ │ │
│     │ │   │   │   │ │ │   │         │ │ │ │       │     │ │     │ │ │       │ │
│ ┌─╴ │ └─┐ └─┐ ├─┬─┘ ╵ │ ╶─┘ ┌───────┘ │ │ ╵ ┌─┐ ╶─┘ ╶───┘ ├───┐ ╵ │ └─┬───┐ │ │
│ │   │   │   │ │ │     │     │         │ │   │ │           │   │   │   │   │ │ │
│ │ ╷ ├─┐ └───┘ │ ╵ ┌─┬─┘ ┌───┤ ╶─┬───┬─┘ └───┘ ├─────┬───┐ │ ╷ └─┬─┴─┐ ╵ ╷ └─┘ │
│ │ │ │ │       │   │ │   │   │   │   │         │     │   │ │ │   │   │   │     │
├─┘ │ ╵ └─┬─────┘ ┌─┘ │ ╶─┘ ╷ ├─┐ └─┐ ╵ ╶─┬───┐ │ ╶─┐ │ ╷ └─┤ ├─┐ ╵ ╷ └─┐ └─────┤
│   │     │       │   │     │ │ │   │     │   │ │   │ │ │   │ │ │   │   │       │
│ ┌─┘ ┌───┘ ┌───┬─┘ ╶─┴─────┤ │ └─┐ ├─────┘ ╷ └─┴─╴ │ │ ├─╴ │ ╵ └───┴─┐ ├─┬───┐ │
│ │   │     │   │           │ │   │ │       │       │ │ │   │         │ │ │   │ │
│ │ ╶─┤ ╶───┤ ╷ │ ╶─┬───┐ ╶─┘ └─┐ │ ╵ ┌─────┴─┐ ┌───┤ │ │ ╶─┴─┬─────╴ │ │ ╵ ╷ ╵ │
│ │   │     │ │ │   │   │       │ │   │       │ │   │ │ │     │       │ │   │   │
│ ├───┴─┬─╴ │ │ ├─╴ └─╴ ├─────┐ ╵ └─┬─┘ ┌───┐ └─┘ ╷ │ │ └───┐ │ ╶───┬─┤ └─┐ └─┬─┤
│ │     │   │ │ │       │     │     │   │   │     │ │ │     │ │     │ │   │   │ │
│ │ ╶─┐ │ ╶─┤ │ └───┬───┘ ┌─┐ └─┐ ┌─┘ ┌─┘ ╷ ├─────┤ │ └───╴ │ └─┬─╴ ╵ └─┐ ├─┐ │ │
│ │   │ │   │ │     │     │ │   │ │   │   │ │     │ │       │   │       │ │ │ │ │
│ └─╴ │ └─┐ ╵ ├───╴ │ ┌───┘ └─┐ ├─┘ ┌─┘ ┌─┤ │ ╶─┐ │ └─────┐ └─┐ │ ╶─┬───┘ │ ╵ ╵ │
│     │   │   │     │ │       │ │   │   │ │ │   │ │       │   │ │   │     │     │
├─────┴─╴ └─┬─┤ ┌───┘ └───┐ ╷ │ ╵ ┌─┤ ╶─┘ │ │ ┌─┘ └─┬───┐ └─┬─┘ └─┐ │ ╶───┴───┐ │
│           │ │ │         │ │ │   │ │     │ │ │     │   │   │     │ │         │ │
│ ┌───────┐ ╵ │ └─────┐ ╷ │ ├─┴───┘ ├───┐ │ │ │ ╶───┘ ╷ └─┐ │ ┌─╴ │ ├─┬───┐ ╷ │ │
│ │       │   │       │ │ │ │       │   │ │ │ │       │   │ │ │   │ │ │   │ │ │ │
│ │ ╶─┬─┐ └─╴ ├─────┐ └─┘ │ │ ╶─┐ ┌─┘ ╷ ╵ │ │ ├───────┴─┐ ╵ │ │ ┌─┘ │ │ ╷ └─┤ └─┤
│ │   │ │     │     │     │ │   │ │   │   │ │ │         │   │ │ │   │ │ │   │   │
│ ├─╴ │ └─┬───┤ ╶─┐ └───┬─┘ └─┐ │ │ ╶─┼───┘ │ │ ╶─┐ ╶───┴─┬─┘ ├─┘ ┌─┘ │ └─┐ └─╴ │
│ │   │   │   │   │     │     │ │ │   │     │ │   │       │   │   │   │   │     │
│ │ ┌─┘ ╷ └─┐ ├─╴ ├─┬─╴ │ ┌─┐ ╵ │ └─╴ │ ╶───┤ └─┐ ├───┐ ╷ │ ╶─┘ ┌─┘ ╷ └─┐ └─────┤
│ │ │   │   │ │   │ │   │ │ │   │     │     │   │ │   │ │ │     │   │   │       │
│ │ ╵ ┌─┴─┐ │ ╵ ╶─┘ │ ╷ │ ╵ ├───┴─┬───┤ ╶─┐ └─┐ └─┘ ╷ ╵ │ └───┐ └─┬─┴─╴ ├─┬───╴ │
│ │   │   │ │       │ │ │   │     │   │   │   │     │   │     │   │     │ │     │
│ ├───┴─┐ │ └─┬───┐ │ └─┴─╴ ├─╴ ╷ │ ╷ └───┴─╴ ├─────┴─┬─┴───╴ ├─╴ │ ╶─┐ ╵ │ ╶─┐ │
│ │     │ │   │   │ │       │   │ │ │         │       │       │   │   │   │   │ │
│ │ ╶─┐ │ └─┐ │ ╷ │ ├───────┘ ╷ ├─┘ │ ┌───────┘ ┌───╴ │ ┌─────┤ ╶─┴─╴ ├─╴ ├─╴ │ │
│ │   │ │   │ │ │ │ │         │ │   │ │         │     │ │     │       │   │   │ │
│ └─╴ │ └─┐ ╵ │ │ ╵ └───────┐ │ │ ┌─┴─┤ ╶───┬───┤ ╶───┘ │ ┌───┴───────┤ ╶─┤ ╶─┤ │
│     │   │   │ │           │ │ │ │   │     │   │       │ │           │   │   │ │
├─────┴─╴ │ ╶─┴─┤ ┌─────┬─┐ │ │ │ ╵ ╷ └───┐ │ ╶─┴───────┘ │ ╶─┬───┐ ╶─┴─╴ └─┐ │ │
│         │     │ │     │ │ │ │ │   │     │ │             │   │   │         │ │ │
│ ╶───────┼───╴ └─┤ ╶─┐ │ ╵ │ └─┴───┴─┐ ╶─┤ │ ╶─┬───┐ ╶─┐ └─┐ │ ┌─┴───┬─────┤ └─┤
│         │       │   │ │   │         │   │ │   │   │   │   │ │ │     │     │   │
│ ╶─┬───┐ └───┬─┐ │ ╷ │ │ ┌─┴─┐ ╷ ╷ ┌─┴─┐ │ └─┬─┘ ╷ └─┬─┴─╴ │ │ ╵ ┌─╴ │ ╶─┐ └─╴ │
│   │   │     │ │ │ │ │ │ │   │ │ │ │   │ │   │   │   │     │ │   │   │   │     │
├─╴ │ ╷ ├─┬─╴ │ ╵ ├─┘ │ │ ╵ ╷ └─┤ │ │ ╷ ╵ ├─╴ │ ┌─┼─╴ │ ╶───┘ ├───┤ ╶─┴─┐ └─┬─╴ │
│   │ │ │ │   │   │   │ │   │   │ │ │ │   │   │ │ │   │       │   │     │   │   │
│ ╶─┘ │ │ │ ┌─┘ ╶─┘ ┌─┤ └───┴─┐ │ │ │ └───┤ ╶─┘ │ │ ╶─┤ ╶─────┘ ╷ └───┐ └─┐ └─┐ │
│     │ │ │ │       │ │       │ │ │ │     │     │ │   │         │     │   │   │ │
├───┬─┤ │ │ └───────┤ └─────┐ │ ╵ │ └───┐ └─────┘ ├─┐ └─┬───────┼───╴ │ ╷ └─┐ └─┤
│   │ │ │ │         │       │ │   │     │         │ │   │       │     │ │   │   │
│ ╷ ╵ │ ╵ └─┬─────┐ │ ┌─┐ ┌─┘ │ ┌─┴─┬─╴ └───┬─╴ ╷ ╵ ├─╴ │ ╶─┬───┤ ┌─┬─┘ └─┐ └─┐ │
│ │   │     │     │ │ │ │ │   │ │   │       │   │   │   │   │   │ │ │     │   │ │
│ └─┐ ├───┐ └─┐ ╷ │ │ ╵ │ ╵ ╶─┴─┘ ╷ └───────┤ ╶─┤ ┌─┘ ┌─┘ ╷ ╵ ╷ ╵ │ ╵ ┌───┘ ┌─┘ │
│   │ │   │   │ │ │ │   │         │         │   │ │   │   │   │   │   │     │   │
├─╴ ├─┘ ╷ └─┐ ╵ │ │ └─┐ ├─┬───────┴─┬─────┐ ├─╴ ├─┘ ┌─┘ ╶─┴───┼───┴─┬─┘ ┌─┐ │ ╷ │
│   │   │   │   │ │   │ │ │         │     │ │   │   │         │     │   │ │ │ │ │
│ ╷ │ ┌─┤ ╶─┴───┤ ├─┐ │ ╵ │ ╶───┬─╴ │ ╶─┐ ╵ ╵ ╷ │ ╶─┴─┐ ┌───┐ ╵ ┌─╴ │ ┌─┤ ╵ │ └─┤
│ │ │ │ │       │ │ │ │   │     │   │   │     │ │     │ │   │   │   │ │ │   │   │
│ │ │ ╵ └─┬───╴ │ │ │ └─┐ └─┬─╴ │ ╶─┴───┴───┬─┴─┴───╴ ├─┘ ╷ └───┴─┐ ╵ │ ╵ ╶─┴─┐ │
│ │ │     │     │ │ │   │   │   │           │         │   │       │   │       │ │
│ └─┴─┐ ┌─┘ ┌─╴ │ ╵ ├─┐ └─┐ │ ╶─┼───────┬─╴ │ ┌─────┬─┘ ┌─┼─────┐ └─┬─┴─┬─────┘ │
│     │ │   │   │   │ │   │ │   │       │   │ │     │   │ │     │   │   │       │
│ ╶─┐ ╵ │ ╶─┴───┴─╴ ╵ └─┐ └─┴─╴ └─╴ ┌─╴ │ ╶─┘ ╵ ┌─╴ └─╴ │ ╵ ╷ ╶─┴─╴ ╵ ╷ ╵ ┌───╴ │
│   │   │               │           │   │       │       │   │         │   │     │
└───┴───┴───────────────┴───────────┴───┴───────┴───────┴───┴─────────┴───┴───╴ │