────┬───────┬───┬───────────────────────┬─────┬─┬─────────┬─────────────┬───────┐
 · ·│  · · ·│· ·│  · · · · · · · · · · ·│     │ │         │             │       │
┌─┐ └─╴ ┌─┐ │ ╷ └─╴ ┌─────────┬───────╴ │ ╷ ╷ ╵ │ ┌─┐ ┌─╴ │ ┌───┐ ┌───╴ ├─╴ ┌─╴ │
│ │· · ·│ │·│·│· · ·│· · · ·  │· · · · ·│ │ │   │ │ │ │   │ │   │ │     │   │   │
│ └─────┤ ╵ │ └─┬─┬─┘ ┌───┐ ╶─┤ ╶───┬───┴─┤ ├───┘ │ │ └─┐ └─┘ ╷ ╵ │ ┌─┬─┘ ╶─┴─┐ │
│       │· ·│· ·│ │· ·│   │· ·│· · ·│  · ·│ │     │ │   │     │   │ │ │       │ │
│ ╷ ╷ ┌─┘ ┌─┴─╴ │ │ ┌─┴─╴ ├─╴ └───┐ └─┐ ╷ │ ╵ ╶───┤ └─┐ ├─────┼───┘ │ ╵ ┌───╴ │ │
│ │ │ │· ·│· · ·│ │·│     │· ·    │· ·│·│·│       │   │ │     │     │   │     │ │
│ │ ├─┘ ┌─┘ ╶─┬─┘ ╵ ├─╴ ┌─┘ ┌─────┴─┐ ╵ │ │ ┌───┐ ╵ ╷ │ │ ╷ ┌─┘ ┌───┴─┬─┘ ┌───┤ │
│ │ │· ·│  · ·│· · ·│   │· ·│· · · ·│· ·│·│ │   │   │ │ │ │ │   │     │   │   │ │
├─┘ │ ┌─┴───╴ │ ┌───┘ ╶─┤ ╶─┘ ┌─┬─╴ ├───┘ ├─┘ ╷ ├───┤ │ │ ├─┘ ┌─┘ ┌─┐ ╵ ┌─┘ ╷ │ │
│   │·│· · · ·│·│       │· · ·│ │· ·│· · ·│   │ │   │ │ │ │   │   │ │   │   │ │ │
│ ╶─┘ │ ╶─────┤ │ ┌───┐ └─────┘ │ ╶─┘ ┌───┘ ┌─┤ └─┐ ╵ │ │ ╵ ┌─┴─┐ │ └───┴───┘ │ │
│· · ·│· · · ·│·│ │   │         │· · ·│     │ │   │   │ │   │   │ │           │ │
│ ╶─┬─┘ ╶─┬─╴ │ │ ╵ ╷ └─┐ ╶─┬─╴ ├───┬─┴───╴ │ └─╴ │ ┌─┘ │ ╶─┘ ╷ ╵ ├───╴ ┌───╴ │ │
│· ·│     │· ·│·│   │   │   │   │   │       │     │ │   │     │   │     │     │ │
├─┐ └───┐ │ ╶─┤ └─┬─┴───┤ ╷ │ ┌─┘ ╷ ╵ ╷ ┌───┤ ╶───┴─┘ ┌─┼─────┴─┬─┘ ╶─┬─┤ ┌───┤ │
│ │· · ·│ │· ·│· ·│· · ·│ │ │ │   │   │ │   │         │ │       │     │ │ │   │ │
│ └───┐ │ └─┐ └─┐ ╵ ┌─┐ ├─┘ ├─┘ ╶─┴───┤ │ ╷ ├───────┬─┘ ╵ ┌─┐ ╶─┘ ┌─┐ │ ╵ └─╴ │ │
│     │·│   │· ·│· ·│ │·│   │         │ │ │ │       │     │ │     │ │ │       │ │
│ ┌─╴ │ └─┐ └─┐ ├─┬─┘ ╵ │ ╶─┘ ┌───────┘ │ │ ╵ ┌─┐ ╶─┘ ╶───┘ ├───┐ ╵ │ └─┬───┐ │ │
│ │   │· ·│   │·│ │· · ·│     │         │ │   │ │           │   │   │   │   │ │ │
│ │ ╷ ├─┐ └───┘ │ ╵ ┌─┬─┘ ┌───┤ ╶─┬───┬─┘ └───┘ ├─────┬───┐ │ ╷ └─┬─┴─┐ ╵ ╷ └─┘ │
│ │ │ │ │· · · ·│· ·│ │   │   │   │   │         │     │   │ │ │   │   │   │     │
├─┘ │ ╵ └─┬─────┘ ┌─┘ │ ╶─┘ ╷ ├─┐ └─┐ ╵ ╶─┬───┐ │ ╶─┐ │ ╷ └─┤ ├─┐ ╵ ╷ └─┐ └─────┤
│   │     │· · · ·│   │     │ │ │   │     │   │ │   │ │ │   │ │ │   │   │       │
│ ┌─┘ ┌───┘ ┌───┬─┘ ╶─┴─────┤ │ └─┐ ├─────┘ ╷ └─┴─╴ │ │ ├─╴ │ ╵ └───┴─┐ ├─┬───┐ │
│ │   │· · ·│· ·│           │ │   │ │       │       │ │ │   │         │ │ │   │ │
│ │ ╶─┤ ╶───┤ ╷ │ ╶─┬───┐ ╶─┘ └─┐ │ ╵ ┌─────┴─┐ ┌───┤ │ │ ╶─┴─┬─────╴ │ │ ╵ ╷ ╵ │
│ │   │· · ·│·│·│   │   │       │ │   │· · · ·│ │· ·│ │ │     │       │ │   │   │
│ ├───┴─┬─╴ │ │ ├─╴ └─╴ ├─────┐ ╵ └─┬─┘ ┌───┐ └─┘ ╷ │ │ └───┐ │ ╶───┬─┤ └─┐ └─┬─┤
│ │     │· ·│·│·│       │· · ·│     │· ·│   │· · ·│·│ │     │ │     │ │   │   │ │
│ │ ╶─┐ │ ╶─┤ │ └───┬───┘ ┌─┐ └─┐ ┌─┘ ┌─┘ ╷ ├─────┤ │ └───╴ │ └─┬─╴ ╵ └─┐ ├─┐ │ │
│ │   │ │· ·│·│· · ·│· · ·│ │· ·│ │· ·│   │ │· · ·│·│       │   │       │ │ │ │ │
│ └─╴ │ └─┐ ╵ ├───╴ │ ┌───┘ └─┐ ├─┘ ┌─┘ ┌─┤ │ ╶─┐ │ └─────┐ └─┐ │ ╶─┬───┘ │ ╵ ╵ │
│     │   │· ·│· · ·│·│       │·│· ·│   │ │ │·  │·│· · · ·│   │ │   │     │     │
├─────┴─╴ └─┬─┤ ┌───┘ └───┐ ╷ │ ╵ ┌─┤ ╶─┘ │ │ ┌─┘ └─┬───┐ └─┬─┘ └─┐ │ ╶───┴───┐ │
│           │ │·│    · · ·│ │ │· ·│ │     │ │·│· ·  │· ·│· ·│     │ │         │ │
│ ┌───────┐ ╵ │ └─────┐ ╷ │ ├─┴───┘ ├───┐ │ │ │ ╶───┘ ╷ └─┐ │ ┌─╴ │ ├─┬───┐ ╷ │ │
│ │       │   │· · · ·│ │·│ │       │   │ │ │·│· · · ·│· ·│·│ │   │ │ │   │ │ │ │
│ │ ╶─┬─┐ └─╴ ├─────┐ └─┘ │ │ ╶─┐ ┌─┘ ╷ ╵ │ │ ├───────┴─┐ ╵ │ │ ┌─┘ │ │ ╷ └─┤ └─┤
│ │   │ │     │     │· · ·│ │   │ │   │   │ │·│         │· ·│ │ │   │ │ │   │   │
│ ├─╴ │ └─┬───┤ ╶─┐ └───┬─┘ └─┐ │ │ ╶─┼───┘ │ │ ╶─┐ ╶───┴─┬─┘ ├─┘ ┌─┘ │ └─┐ └─╴ │
│ │   │   │   │   │     │     │ │ │   │     │·│   │    · ·│   │   │   │   │     │
│ │ ┌─┘ ╷ └─┐ ├─╴ ├─┬─╴ │ ┌─┐ ╵ │ └─╴ │ ╶───┤ └─┐ ├───┐ ╷ │ ╶─┘ ┌─┘ ╷ └─┐ └─────┤
│ │ │   │   │ │   │ │   │ │ │   │     │     │· ·│ │· ·│·│·│     │   │   │       │
│ │ ╵ ┌─┴─┐ │ ╵ ╶─┘ │ ╷ │ ╵ ├───┴─┬───┤ ╶─┐ └─┐ └─┘ ╷ ╵ │ └───┐ └─┬─┴─╴ ├─┬───╴ │
│ │   │   │ │       │ │ │   │     │   │   │   │· · ·│· ·│· · ·│   │     │ │     │
│ ├───┴─┐ │ └─┬───┐ │ └─┴─╴ ├─╴ ╷ │ ╷ └───┴─╴ ├─────┴─┬─┴───╴ ├─╴ │ ╶─┐ ╵ │ ╶─┐ │
│ │     │ │   │   │ │       │   │ │ │         │· · · ·│· · · ·│   │   │   │   │ │
│ │ ╶─┐ │ └─┐ │ ╷ │ ├───────┘ ╷ ├─┘ │ ┌───────┘ ┌───╴ │ ┌─────┤ ╶─┴─╴ ├─╴ ├─╴ │ │
│ │   │ │   │ │ │ │ │         │ │   │ │· · · · ·│· · ·│·│     │       │   │   │ │
│ └─╴ │ └─┐ ╵ │ │ ╵ └───────┐ │ │ ┌─┴─┤ ╶───┬───┤ ╶───┘ │ ┌───┴───────┤ ╶─┤ ╶─┤ │
│     │   │   │ │           │ │ │ │   │· · ·│   │· · · ·│ │           │   │   │ │
├─────┴─╴ │ ╶─┴─┤ ┌─────┬─┐ │ │ │ ╵ ╷ └───┐ │ ╶─┴───────┘ │ ╶─┬───┐ ╶─┴─╴ └─┐ │ │
│         │     │ │     │ │ │ │ │   │     │·│             │   │   │         │ │ │
│ ╶───────┼───╴ └─┤ ╶─┐ │ ╵ │ └─┴───┴─┐ ╶─┤ │ ╶─┬───┐ ╶─┐ └─┐ │ ┌─┴───┬─────┤ └─┤
│         │       │   │ │   │         │   │·│   │· ·│   │   │ │ │     │     │   │
│ ╶─┬───┐ └───┬─┐ │ ╷ │ │ ┌─┴─┐ ╷ ╷ ┌─┴─┐ │ └─┬─┘ ╷ └─┬─┴─╴ │ │ ╵ ┌─╴ │ ╶─┐ └─╴ │
│   │   │     │ │ │ │ │ │ │   │ │ │ │   │ │· ·│· ·│· ·│     │ │   │   │   │     │
├─╴ │ ╷ ├─┬─╴ │ ╵ ├─┘ │ │ ╵ ╷ └─┤ │ │ ╷ ╵ ├─╴ │ ┌─┼─╴ │ ╶───┘ ├───┤ ╶─┴─┐ └─┬─╴ │
│   │ │ │ │   │   │   │ │   │   │ │ │ │   │· ·│·│ │· ·│       │   │     │   │   │
│ ╶─┘ │ │ │ ┌─┘ ╶─┘ ┌─┤ └───┴─┐ │ │ │ └───┤ ╶─┘ │ │ ╶─┤ ╶─────┘ ╷ └───┐ └─┐ └─┐ │
│     │ │ │ │       │ │       │ │ │ │     │· · ·│ │· ·│         │     │   │   │ │
├───┬─┤ │ │ └───────┤ └─────┐ │ ╵ │ └───┐ └─────┘ ├─┐ └─┬───────┼───╴ │ ╷ └─┐ └─┤
│   │ │ │ │         │       │ │   │     │         │ │· ·│       │     │ │   │   │
│ ╷ ╵ │ ╵ └─┬─────┐ │ ┌─┐ ┌─┘ │ ┌─┴─┬─╴ └───┬─╴ ╷ ╵ ├─╴ │ ╶─┬───┤ ┌─┬─┘ └─┐ └─┐ │
│ │   │     │     │ │ │ │ │   │ │   │       │   │   │· ·│   │   │ │ │     │   │ │
│ └─┐ ├───┐ └─┐ ╷ │ │ ╵ │ ╵ ╶─┴─┘ ╷ └───────┤ ╶─┤ ┌─┘ ┌─┘ ╷ ╵ ╷ ╵ │ ╵ ┌───┘ ┌─┘ │
│   │ │   │   │ │ │ │   │         │         │   │ │· ·│   │   │   │   │     │   │
├─╴ ├─┘ ╷ └─┐ ╵ │ │ └─┐ ├─┬───────┴─┬─────┐ ├─╴ ├─┘ ┌─┘ ╶─┴───┼───┴─┬─┘ ┌─┐ │ ╷ │
│   │   │   │   │ │   │ │ │         │     │ │   │· ·│         │     │   │ │ │ │ │
│ ╷ │ ┌─┤ ╶─┴───┤ ├─┐ │ ╵ │ ╶───┬─╴ │ ╶─┐ ╵ ╵ ╷ │ ╶─┴─┐ ┌───┐ ╵ ┌─╴ │ ┌─┤ ╵ │ └─┤
│ │ │ │ │       │ │ │ │   │     │   │   │     │ │· · ·│ │· ·│   │   │ │ │   │   │
│ │ │ ╵ └─┬───╴ │ │ │ └─┐ └─┬─╴ │ ╶─┴───┴───┬─┴─┴───╴ ├─┘ ╷ └───┴─┐ ╵ │ ╵ ╶─┴─┐ │
│ │ │     │     │ │ │   │   │   │           │· · · · ·│· ·│· · · ·│   │       │ │
│ └─┴─┐ ┌─┘ ┌─╴ │ ╵ ├─┐ └─┐ │ ╶─┼───────┬─╴ │ ┌─────┬─┘ ┌─┼─────┐ └─┬─┴─┬─────┘ │
│     │ │   │   │   │ │   │ │   │       │   │·│· · ·│  ·│ │     │· ·│· ·│· · · ·│
│ ╶─┐ ╵ │ ╶─┴───┴─╴ ╵ └─┐ └─┴─╴ └─╴ ┌─╴ │ ╶─┘ ╵ ┌─╴ └─╴ │ ╵ ╷ ╶─┴─╴ ╵ ╷ ╵ ┌───╴ │
│   │   │               │           │   │    · ·│  · · ·│   │      · ·│· ·│    ·│
└───┴───┴───────────────┴───────────┴───┴───────┴───────┴───┴─────────┴───┴───╴ │