────────┐
        │
┌───┬─╴ │
│   │   │
│ ┌─┘ ┌─┤
│ │   │ │
│ ╵ ╶─┘ │
│•      │
└─────╴ │