────────┐
 •      │
╷       │
│       │
│       │
│       │
│       │
│       │
└─────╴ │