────┬─────┐
    │     │
┌─╴ │ ╷ ╷ │
│   │ │ │ │
│ ╶─┤ │ │ │
│   │ │ │ │
├─╴ ├─┘ │ │
│   │   │ │
│ ╶─┘ ┌─┘ │
│     │   │
└─────┴─╴ │