────────┐
        │
┌───┬─╴ │
│   │•  │
│ ┌─┘ ┌─┤
│ │   │ │
│ ╵ ╶─┘ │
│       │
└─────╴ │