────────┐
 · · · ·│
┌───┬─╴ │
│   │· ·│
│ ┌─┘ ┌─┤
│ │· ·│ │
│ ╵ ╶─┘ │
│  · · ·│
└─────╴ │