────────┐
   •    │
╷       │
│       │
│       │
│       │
│       │
│       │
└─────╴ │