────────┐
        │
┌───┬─╴ │
│   │  •│
│ ┌─┘ ┌─┤
│ │   │ │
│ ╵ ╶─┘ │
│       │
└─────╴ │