────────┐
 •      │
┌───┬─╴ │
│   │   │
│ ┌─┘ ┌─┤
│ │   │ │
│ ╵ ╶─┘ │
│       │
└─────╴ │