────────┐
 •      │
┌─────╴ │
│       │
│ ┌─╴ ╷ │
│ │   │ │
│ ╵ ╶─┘ │
│       │
└─────╴ │