────────┐
        │
┌───┬─╴ │
│   │   │
│ ┌─┘ ┌─┤
│•│   │ │
│ ╵ ╶─┘ │
│       │
└─────╴ │