────────┐
        │
┌───┬─╴ │
│   │   │
│ ┌─┘ ┌─┤
│ │   │ │
│ ╵ ╶─┘ │
│  •    │
└─────╴ │