────┬─────┐
 · ·│  · ·│
┌─╴ │ ╷ ╷ │
│· ·│ │·│·│
│ ╶─┤ │ │ │
│· ·│ │·│·│
├─╴ ├─┘ │ │
│· ·│· ·│·│
│ ╶─┘ ┌─┘ │
│· · ·│  ·│
└─────┴─╴ │